Gg, Gg, Gg, Gg, Gg, Gg, Gg, Gg, Gg, Gg, Gg, Gg
Gg, Gg, Gg, Gg, Gg, Gg, Gg, Gg, Gg, Gg, Gg^Ve, Gg
Gg, Gg, Gg, Gg, Gg, Gg, Gg, Gg, Gg^Ve, Gg, Gg, Gg
Gg, Gg, Gg, Gg, Gg, 1 Ch, Gg, Gg, Gg, Gg, Gg, Gg
Gg, Gg, Gg, Gg^Ve, Gg, Gg, Gg, Gg^Ve, Gg, Gg, Gg, Gg
Gg, Gg, Gg, Gg, Gg, Gg, Gg, Gg, Gg, Gg, Gg, Gg
Gg, Gg, Gg, Gg, Gg, Gg, Gg, Gg, Gg, Gg, Gg, Gg
Gg, Gg, Gg, Gg, Gg^Ve, Gg, Gg, Gg, Gg^Ve, Gg, Gg, Gg
Gg, Gg, Gg, Gg, Gg, Gg, 2 Ch, Gg, Gg, Gg, Gg, Gg
Gg, Gg, Gg, Gg^Ve, Gg, Gg, Gg, Gg, Gg, Gg, Gg, Gg
Gg, Gg^Ve, Gg, Gg, Gg, Gg, Gg, Gg, Gg, Gg, Gg, Gg
Gg, Gg, Gg, Gg, Gg, Gg, Gg, Gg, Gg, Gg, Gg, Gg